11111111111111111111111111111111
10000000100000000000000000011111
1E0C0000100000000000001110000001
10000C00100000000000000011110001
10000000001000000000000000110001
111100000000P0100000000001100101
1C000000011111111111111110000001
1111111110000000C0000000C0000001
11111111111111111111111111111111