111111111111
1000C000E001
10P00C000001
111111111111