111111111111111111111111111111111111111111
111111111111100000000000000000010000100001
11111111111110C000000000000P00001111111111
1111111111111111110001C1111110000111111111
11111111000000100000000000CCC0001100000001
100000000000000000000000000000000000000001
100000011110000010000000000000000000000001
1000C00000000000000000000C0000000000000001
100000000000E00000000000000000000000000001
100000000000000000000000000000000000000001
111111111111111111111111111111111111111101
100000000000000000000000000000000000000001
10000C0000000000000000000000000C0000000001
1000000000C0000000000000000000000000000001
1000000000000000000000000000000000000C0001
111111111111111111111111111111111110000001
100000000000000000000000000000000000000001
10000000000CCC0000000000000000C00000000001
100000000000000000000000000000000000000001
10000000C000000000000000000000000000000001
100000000000000000000000000000000000000001
100000000000000000000000000000000000000001
111111111111111111111111111111111111111111