11111111111111
1011111111011
1PCE000000001
1100000000111
1000000000001
1111111111111