11111111
1000P001
10E00001
11111111