10111111111
1000E000001
100C000P001
11111111111