1111111111
1000P00001
10E00PC001
1111111111